########################################
.......................................#
.......................................#
.......................................#
.......................................#
.......................................#
.......................................#
.......................................#
.......................................#
...............................#########
...............P...............x.......#
...............................#########
.......................................#
.......................................#
.......................................#
..........................##############
..........................#
..........................#
..........................#
..........................#
..........................#
###########################