#########################################
#.......................................#
#.......................................#
#.......................................#
#.......................................#
#.......................................#
#.......................................#                      ############################################################################
#.......................................#                      #......................#..............................#....................#
#.......................................#                      #......................#..............................#....................#
#...............................################################......................#..............................#....................#
#...............P...............X.x....................X..............................X..............................X....................#
#...............................################################......................#..............................#....................#
#.......................................#                      #......................#..............................#....................#
#.......................................#                      #......................#..............................#....................#
#.............X.........................#                      ############################################################################               
#..........................##############
#..........................#
#..........................#
#..........................#
#..........................#
#..........................#
###########################